20
33
1 1 1 1 1 1 1 1 1 1 1 1 1 1 1 1 1 1 1 1 1 1 1 1 1 1 1 1 1 1 1 1 1
1 0 0 0 0 0 0 0 0 0 0 0 0 0 0 10 10 10 -1 -2 -3 7 0 11 0 7 0 0 0 0 0 0 1
1 0 0 0 0 0 0 0 0 0 0 0 0 0 0 10 10 10 -1 -2 -3 11 0 11 0 11 0 0 0 0 0 0 1
1 7 7 9 11 9 11 9 11 9 11 9 11 9 11 10 10 10 -1 -2 -3 11 0 11 0 11 0 0 0 0 0 0 1
1 0 0 0 0 0 0 0 0 0 0 0 0 0 0 10 10 10 -1 -2 -3 11 0 11 0 11 0 0 0 0 0 0 1
1 0 0 0 0 0 0 0 0 0 0 0 0 0 0 10 10 10 -1 -2 -3 11 0 7 0 11 0 0 0 0 0 0 1
1 10 10 10 7 7 7 10 10 10 10 10 10 10 10 6 11 6 10 10 10 10 10 10 10 9 7 7 7 9 11 11 1
1 0 0 7 0 0 0 0 0 0 0 0 0 0 0 11 11 11 0 0 0 0 0 0 0 11 0 0 0 0 0 0 1
1 0 0 7 0 0 0 0 0 0 0 0 0 0 0 7 0 7 0 0 0 0 0 0 0 7 0 0 0 0 0 0 1
1 0 0 11 0 0 0 0 0 0 0 0 0 0 0 7 0 7 0 0 0 0 0 0 0 7 0 0 7 11 0 0 1
1 0 0 11 0 0 0 0 0 0 0 0 0 0 0 7 0 7 0 0 0 0 0 0 0 7 0 0 11 7 0 0 1
1 0 0 9 0 0 0 0 0 0 0 0 0 0 0 11 11 11 0 0 0 0 0 0 0 11 0 0 7 11 0 0 1
1 0 0 11 7 7 9 10 10 10 10 10 10 10 10 6 11 6 10 10 10 10 10 10 10 11 0 0 7 9 0 0 1
1 0 0 11 0 0 0 0 0 0 0 0 0 11 0 10 10 10 0 0 0 0 0 0 0 11 0 0 11 7 0 0 1
1 0 0 11 0 0 0 0 0 0 0 0 0 11 0 10 10 10 0 0 0 0 0 0 0 11 0 0 11 7 0 0 1
1 10 11 10 11 11 9 7 7 7 7 7 11 11 0 10 10 10 0 10 11 10 11 10 0 11 0 0 9 11 0 0 1
1 0 0 0 0 0 7 0 0 0 0 0 0 11 0 10 10 10 0 0 0 0 0 0 0 11 0 0 11 7 0 0 1
1 0 0 0 0 0 7 0 0 0 0 0 0 11 0 10 10 10 0 0 0 0 0 0 0 11 0 00 7 11 0 0 1
1 0 0 0 0 0 7 0 0 0 0 0 0 7 0 10 10 10 0 0 0 0 0 0 0 0 0 0 11 7 0 0 1
1 1 1 1 1 1 1 1 1 1 1 1 1 1 1 1 1 1 1 1 1 1 1 1 1 1 1 1 1 1 1 1 1
           