20
33
1 1 1 1 1 1 1 1 1 1 1 1 1 1 1 1 1 1 1 1 1 1 1 1 1 1 1 1 1 1 1 1 1
1 0 0 0 5 0 0 0 0 0 0 0 0 0 0 0 0 0 0 0 0 0 0 0 0 0 0 0 5 0 0 0 1
1 0 2 0 5 0 0 0 0 0 0 0 0 0 0 0 0 0 0 0 0 0 0 0 0 0 0 0 5 0 2 0 1
1 0 0 0 5 0 0 0 0 0 10 5 5 5 5 7 7 7 5 5 5 5 10 0 0 0 0 0 5 0 0 0 1
1 7 7 7 5 0 0 0 0 0 5 0 0 0 0 0 0 0 0 0 0 0 5 0 0 0 0 0 5 7 7 7 1
1 0 0 0 7 0 0 0 0 0 5 0 6 10 5 7 7 7 5 10 6 0 5 0 0 0 0 0 7 0 0 0 1
1 0 0 0 7 0 0 0 0 0 5 0 10 0 0 0 0 0 0 0 10 0 5 0 0 0 0 0 7 0 0 0 1
1 0 0 0 7 0 0 0 0 0 5 0 5 0 4 1 1 1 1 0 5 0 5 0 0 0 0 0 7 0 0 0 1
1 0 0 0 5 0 0 0 0 0 7 0 7 0 1 1 1 1 1 0 7 0 7 0 0 0 0 0 5 0 0 0 1
1 0 0 0 5 0 0 0 0 0 7 0 7 0 1 1 1 1 1 0 7 0 7 0 0 0 0 0 5 0 0 0 1
1 0 0 0 5 0 0 0 0 0 7 0 7 0 1 1 1 1 1 0 7 0 7 0 0 0 0 0 5 0 0 0 1
1 0 0 0 5 0 0 0 0 0 5 0 5 0 1 1 1 1 1 0 5 0 5 0 0 0 0 0 5 0 0 0 1
1 0 0 0 7 0 0 0 0 0 5 0 10 0 0 0 0 0 0 0 10 0 5 0 0 0 0 0 7 0 0 0 1
1 0 0 0 7 0 0 0 0 0 5 0 6 10 5 7 7 7 5 10 6 0 5 0 0 0 0 0 7 0 0 0 1
1 0 0 0 7 0 0 0 0 0 5 0 0 0 0 0 0 0 0 0 0 0 5 0 0 0 0 0 7 0 0 0 1
1 7 7 7 5 0 0 0 0 0 10 5 5 5 5 7 7 7 5 5 5 5 10 0 0 0 0 0 5 7 7 7 1
1 0 0 0 5 0 0 0 0 0 0 0 0 0 0 0 0 0 0 0 0 0 0 0 0 0 0 0 5 0 0 0 1
1 0 2 0 5 0 0 0 0 0 0 0 0 0 0 0 0 0 0 0 0 0 0 0 0 0 0 0 5 0 2 0 1
1 0 0 0 5 0 0 0 0 0 0 0 0 0 0 0 0 0 0 0 0 0 0 0 0 0 0 0 5 0 0 0 1
1 1 1 1 1 1 1 1 1 1 1 1 1 1 1 1 1 1 1 1 1 1 1 1 1 1 1 1 1 1 1 1 1
           