20
33
01 01 01 01 01 01 01 01 01 01 01 01 01 01 01 01 01 01 01 01 01 01 01 01 01 01 01 01 01 01 01 01 01
01 01 01 01 01 01 01 01 01 01 01 01 01 01 01 01 01 01 01 01 01 01 01 01 01 01 01 01 01 01 01 01 01
01 01 30 00 00 00 33 00 00 00 30 00 00 00 00 00 00 00 00 00 00 00 30 00 00 00 31 00 00 00 30 01 01
01 01 30 00 00 32 32 32 00 00 30 00 00 00 00 00 00 00 00 00 00 00 30 00 00 33 32 32 00 00 30 01 01
01 01 30 00 32 33 33 32 33 00 30 00 00 00 00 00 00 00 00 00 00 00 30 00 32 31 33 31 31 00 30 01 01
01 01 30 32 00 00 33 00 00 33 30 00 00 00 00 00 00 00 00 00 00 00 30 31 00 00 32 00 00 32 30 01 01
01 01 30 30 30 30 31 30 30 30 30 10 10 10 10 07 07 07 10 10 10 10 30 30 30 30 33 30 30 30 30 01 01
01 01 00 00 00 00 32 00 00 00 00 00 00 00 00 00 00 00 00 00 00 00 00 00 00 00 33 00 00 00 00 01 01
01 01 00 00 00 00 31 00 00 00 00 00 00 00 00 00 00 00 00 00 00 00 00 00 00 00 31 00 00 00 00 01 01
01 01 00 00 00 00 32 00 00 00 00 00 00 00 00 00 00 00 00 00 00 00 00 00 00 00 32 00 00 00 00 01 01
01 01 00 00 00 00 33 00 00 00 00 00 00 00 00 00 00 00 00 00 00 00 00 00 00 00 31 00 00 00 00 01 01
01 01 00 00 00 00 31 00 00 00 00 00 00 00 00 00 00 00 00 00 00 00 00 00 00 00 32 00 00 00 00 01 01
01 01 00 00 00 00 32 00 00 00 00 00 00 00 00 00 00 00 00 00 00 00 00 00 00 00 33 00 00 00 00 01 01
01 01 30 30 30 30 32 30 30 30 30 10 10 10 10 07 07 07 10 10 10 10 30 30 30 30 31 30 30 30 30 01 01
01 01 30 33 00 00 31 00 00 32 30 00 00 00 00 00 00 00 00 00 00 00 30 33 00 00 31 00 00 33 30 01 01
01 01 30 00 32 31 33 32 32 00 30 00 00 00 00 00 00 00 00 00 00 00 30 00 31 32 32 33 31 00 30 01 01
01 01 30 00 00 31 32 32 00 00 30 00 00 00 00 00 00 00 00 00 00 00 30 00 00 33 33 31 00 00 30 01 01
01 01 30 00 00 00 31 00 00 00 30 00 00 00 00 00 00 00 00 00 00 00 30 00 00 00 31 00 00 00 30 01 01
01 01 01 01 01 01 01 01 01 01 01 01 01 01 01 01 01 01 01 01 01 01 01 01 01 01 01 01 01 01 01 01 01
01 01 01 01 01 01 01 01 01 01 01 01 01 01 01 01 01 01 01 01 01 01 01 01 01 01 01 01 01 01 01 01 01
           